XXXXXXAXXXXXXXXXOOO
XXXXXXXXXXXXXXXXOOO
XXOOOOOOOOOOOOXXOOO
XXOOOOOOOOOOOXXXOOO
XXOOOOOOOOOOXXZXOOO
XXOOOOOOOOOOXXXXOOO
XXXXXXXXXXXXXXXXXXX
XXXXXNNNNNNXXXXXXXX
OOOXXXXXXXXXXOOOOXX
OOOOOXXOOOOOOOOOOXX
OOOOOXXOOOOOOOOOOXE
OOOOOXSOOOOOOOOOOXX

rival 1:
3 4
3 4
3 4
5 6

rival 2:
5 6
5 6
5 6
6 7

rival 3:
7 9
7 9
7 9
7 9
8 9
