XXXXXXAXXXXXXXXXOOO
XXXXXXXXXXXXXXXXOOO
XXOOOOOOOOOOOOXXOOO
XXOOOOOOOOOOOXXXOOO
XXOOOOOOOOOOXXZXOOO
XXOOOOOOOOOOXXXXOOO
XXXXXXXXXXXXXXXXXXX
XXXXXNNNNNNXXXXXXXX
OOOXXXXXXXXXXOOOOXX
OOOOOXXOOOOOOOOOOXX
OOOOOXXOOOOOOOOOOXE
OOOOOXSOOOOOOOOOOXX